#######################
# P      ######       #
#    #### X O XX      #
#             OO      #
#######               #
#O        X           #
#######################